15
.he...o.......o.....
....................
....................
....................
o...............o...
..o......o..........
................o...
....................
........o.o....lo...
.......o.o..........
.........yo.........
o...................
.o.....o..o.........
..o..............o..
..........o.........
